BatchNum	1
PatchModel	0
Resolution	100
LandType	9
MaxHabitats	1
SpeciesDist	0
DistResolution	100
Reproduction	0
RepSeasons	1
StageStruct	0
Stages	1
Transfer	0
ParameterFile	ParameterFile_ex3.txt
LandFile	LandFile_ex3.txt
StageStructFile	NULL
EmigrationFile	EmigrationFile_ex3.txt
TransferFile	TransferFile_ex3.txt
SettlementFile	SettlementFile_ex3.txt
GeneticsFile	GeneticsFile_ex3.txt
TraitsFile	TraitsFile_ex3.txt
InitialisationFile	InitialisationFile_ex3.txt
