BatchNum	99
PatchModel	1
Resolution	10
LandType	0
MaxHabitats	7
SpeciesDist	1
DistResolution	10
Reproduction	0
RepSeasons	1
StageStruct	1
Stages	3
Transfer	1
ParameterFile	ParameterFile_ex4C.txt
LandFile	LandFile_ex4.txt
StageStructFile	StageStructFile_ex4C.txt
EmigrationFile	EmigrationFile_ex4C.txt
TransferFile	TransferFile_ex4C.txt
SettlementFile	SettlementFile_ex4C.txt
GeneticsFile	NULL
TraitsFile	NULL
InitialisationFile	InitialisationFile_ex4C.txt

ANY ADDITIONAL LINES ARE NOT READ, AND CAN THEREFORE BE USED FOR COMMENTS

Control file for RangeShifter Tutorial Example 4, estimating connectivity

Patch-based landscape, stage-structured population, transfer by the Stochastic Movement Simulator (SMS)

